150 15
......................................................................................................................................................
......................................................................................................................................................
......................................................................................................................................................
......................................................................................................................................................
......................................................................................................................................................
......................................................................................................................................................
............................~~........................................................................................................................
.................|||||..~~~~--........................................................................................................................
................|~~~~~~~------~.................................&.||||||||||||||||||||||||||||||......|||||||||||||||||||||%.....||||||||||||||||||||.
...............|~--------------||......................~~~~~~~~~~~~~~~~~~~~~~~~~~~~~~~~~~~~~~~~~~~~~~~~~~~~~~~~~~~~~~~~~~~~~~....~~~~~~~~~~~~~~~~~~~~~
~~~~~~~~~~~~~~~~---------------~~~~~~~~~~~~~~~~~|||||||----------------------------------------------------------------------~~~~---------------------
------------------------------------------------~~~~~~~-----------------------------------------------------------------------------------------------
------------------------------------------------------------------------------------------------------------------------------------------------------
------------------------------------------------------------------------------------------------------------------------------------------------------
------------------------------------------------------------------------------------------------------------------------------------------------------



