150 15
......................................................................................................................................................
............................~~........................................................................................................................
............................--........................................................................................................................
............................--........................................................................................................................
............................--........................................................................................................................
............................--........................................................................................................................
.........................&..--........................................................................................................................
.................|||||..~~~~--........................................................................................................................
................|~~~~~~~------~........................|||||||||||||||||||||||||||||||||||||||||..%...|||||||||||||||||||||......||||||||||||||||||||.
.....~.........|~--------------||......................~~~~~~~~~~~~~~~~~~~~~~~~~~~~~~~~~~~~~~~~~~~~~~~~~~~~~~~~~~~~~~~~~~~~~~....~~~~~~~~~~~~~~~~~~~~~
~~~~~-~~~~~~~~~~---------------~~~~~~~~~~~~~~~~~|||||||----------------------------------------------------------------------~~~~---------------------
------------------------------------------------~~~~~~~-----------------------------------------------------------------------------------------------
------------------------------------------------------------------------------------------------------------------------------------------------------
------------------------------------------------------------------------------------------------------------------------------------------------------
------------------------------------------------------------------------------------------------------------------------------------------------------



