150 15
......................................................................................................................................................
......................................................................................................................................................
......................................................................................................................................................
......................................................................................................................................................
......................................................................................................................................................
......................................................................................................................................................
............................~~........................................................................................................................
...............|||||||..~~~~--........................................................................................................................
...............||~~~~~~~------~...................................||||||||||||||||||||||||||||||..%...|||||||||||||||||||||......||||||||||||||||||||.
.....&.........|~--------------||......................~~~~~~~~~~~~~~~~~~~~~~~~~~~~~~~~~~~~~~~~~~~~~~~~~~~~~~~~~~~~~~~~~~~~~~....~~~~~~~~~~~~~~~~~~~~~
~~~~~~~~~~~~~~~~---------------~~~~~~~~~~~~~~~~~|||||||----------------------------------------------------------------------~~~~---------------------
------------------------------------------------~~~~~~~-----------------------------------------------------------------------------------------------
------------------------------------------------------------------------------------------------------------------------------------------------------
------------------------------------------------------------------------------------------------------------------------------------------------------
------------------------------------------------------------------------------------------------------------------------------------------------------



