150 15
......................................................................................................................................................
......................................................................................................................................................
......................................................................................................................................................
......................................................................................................................................................
......................................................................................................................................................
......................................................................................................................................................
............................--........................................................................................................................
...............|||||||..------........................................................................................................................
...............||--------------...................................||||||||||||||||||||||||||||||..%....|||||||||||||||||||||......||||||||||||||||||||
.....&.........|---------------||....................------------------------------------------------------------------------....---------------------
--------------------------------|||||||---------------------------------------------------------------------------------------------------------------
------------------------------------------------------------------------------------------------------------------------------------------------------
------------------------------------------------------------------------------------------------------------------------------------------------------
------------------------------------------------------------------------------------------------------------------------------------------------------
------------------------------------------------------------------------------------------------------------------------------------------------------




---
---
-&-



&--
---
---
